11111111111111111111111111
10100000011111000001000001
1010001001111100000101E101
101100P1010101000001001001
101C0110000000000100001001
11111111111111111111111111