11111111111111111111111111
101P0000010001000001000001
10100000010001000001000001
10100000010C01000001000001
10100000010001000001000001
10100000010001000001000001
10100000010C01000001000001
10100000010010000010000011
1000010000000C0010000010E1
11111111111111111111111111