11111111111111111111111111
101P000001C001000001000001
10100000011011000001000001
10100000010C01000001000001
1000010000000C0010000010E1
11111111111111111111111111